UF;CÓDIGO;NOME;Variável A;Variável B;Variável C;Resultado de A+B+C;
SP;350010;Adamantina;3728;1600;702;6030;
SP;350020;Adolfo;470;153;83;706;
SP;350030;Aguaí;4611;1125;801;6537;
SP;350040;Águas da Prata;725;186;151;1062;
SP;350050;Águas de Lindóia;2335;559;428;3322;
SP;350055;Águas de Santa Bárbara;792;245;166;1203;
SP;350060;Águas de São Pedro;629;203;81;913;
SP;350070;Agudos;4921;1537;917;7375;
SP;350075;Alambari;789;271;86;1146;
SP;350080;Alfredo Marcondes;434;138;74;646;
SP;350090;Altair;478;156;109;743;
SP;350100;Altinópolis;2060;644;361;3065;
SP;350110;Alto Alegre;436;147;77;660;
SP;350115;Alumínio;3203;763;470;4436;
SP;350120;Álvares Florence;397;152;78;627;
SP;350130;Álvares Machado;3190;1076;556;4822;
SP;350140;Álvaro de Carvalho;517;134;114;765;
SP;350150;Alvinlândia;488;123;95;706;
SP;350160;Americana;26060;10239;5175;41474;
SP;350170;Américo Brasiliense;4983;1533;1061;7577;
SP;350180;Américo de Campos;742;264;102;1108;
SP;350190;Amparo;7950;2804;1351;12105;
SP;350200;Analândia;604;182;125;911;
SP;350210;Andradina;6390;2376;1210;9976;
SP;350220;Angatuba;3228;825;591;4644;
SP;350230;Anhembi;988;263;166;1417;
SP;350240;Anhumas;496;160;88;744;
SP;350250;Aparecida;5057;1589;950;7596;
SP;350260;Aparecida d`Oeste;514;175;104;793;
SP;350270;Apiaí;4144;1415;648;6207;
SP;350275;Araçariguama;3143;739;620;4502;
SP;350280;Araçatuba;21627;7396;3846;32869;
SP;350290;Araçoiaba da Serra;4038;1339;824;6201;
SP;350300;Aramina;664;171;117;952;
SP;350310;Arandu;866;276;136;1278;
SP;350315;Arapeí;408;114;67;589;
SP;350320;Araraquara;25154;8821;4315;38290;
SP;350330;Araras;14856;4915;2827;22598;
SP;350335;Arco-Íris;240;59;48;347;
SP;350340;Arealva;1040;288;134;1462;
SP;350350;Areias;598;179;113;890;
SP;350360;Areiópolis;1769;461;311;2541;
SP;350370;Ariranha;1048;330;211;1589;
SP;350380;Artur Nogueira;6474;1612;1237;9323;
SP;350390;Arujá;13747;4422;2189;20358;
SP;350395;Aspásia;208;56;38;302;
SP;350400;Assis;11317;3549;2230;17096;
SP;350410;Atibaia;19886;6263;3259;29408;
SP;350420;Auriflama;1546;567;242;2355;
SP;350430;Avaí;691;265;121;1077;
SP;350440;Avanhandava;1544;341;302;2187;
SP;350450;Avaré;11546;3304;2104;16954;
SP;350460;Bady Bassitt;1959;663;368;2990;
SP;350470;Balbinos;159;43;41;243;
SP;350480;Bálsamo;826;315;181;1322;
SP;350490;Bananal;1425;454;225;2104;
SP;350500;Barão de Antonina;451;158;77;686;
SP;350510;Barbosa;952;243;187;1382;
SP;350520;Bariri;4158;1218;765;6141;
SP;350530;Barra Bonita;3967;1453;779;6199;
SP;350535;Barra do Chapéu;915;295;153;1363;
SP;350540;Barra do Turvo;1415;402;220;2037;
SP;350550;Barretos;13184;4532;2212;19928;
SP;350560;Barrinha;4598;1192;903;6693;
SP;350570;Barueri;51884;17691;9378;78953;
SP;350580;Bastos;2821;798;517;4136;
SP;350590;Batatais;7386;2381;1250;11017;
SP;350600;Bauru;44773;14784;7180;66737;
SP;350610;Bebedouro;9347;3133;1746;14226;
SP;350620;Bento de Abreu;300;104;55;459;
SP;350630;Bernardino de Campos;1317;396;256;1969;
SP;350635;Bertioga;9023;2574;1621;13218;
SP;350640;Bilac;819;247;123;1189;
SP;350650;Birigui;13211;4467;2430;20108;
SP;350660;Biritiba-Mirim;4311;1264;718;6293;
SP;350670;Boa Esperança do Sul;1989;567;329;2885;
SP;350680;Bocaina;1498;414;310;2222;
SP;350690;Bofete;1372;378;242;1992;
SP;350700;Boituva;7268;2278;1246;10792;
SP;350710;Bom Jesus dos Perdões;3080;723;551;4354;
SP;350715;Bom Sucesso de Itararé;777;256;121;1154;
SP;350720;Borá;129;34;27;190;
SP;350730;Boracéia;608;175;122;905;
SP;350740;Borborema;1731;514;277;2522;
SP;350745;Borebi;464;101;79;644;
SP;350750;Botucatu;17016;5414;3206;25636;
SP;350760;Bragança Paulista;21054;6737;3749;31540;
SP;350770;Braúna;611;173;105;889;
SP;350775;Brejo Alegre;391;134;89;614;
SP;350780;Brodowski;3124;761;545;4430;
SP;350790;Brotas;3120;903;532;4555;
SP;350800;Buri;3328;687;483;4498;
SP;350810;Buritama;1873;666;361;2900;
SP;350820;Buritizal;556;113;116;785;
SP;350830;Cabrália Paulista;668;306;109;1083;
SP;350840;Cabreúva;7229;2186;1350;10765;
SP;350850;Caçapava;12164;3846;2176;18186;
SP;350860;Cachoeira Paulista;4417;1326;810;6553;
SP;350870;Caconde;2654;778;389;3821;
SP;350880;Cafelândia;2111;762;406;3279;
SP;350890;Caiabu;485;232;81;798;
SP;350900;Caieiras;13021;4781;2505;20307;
SP;350910;Caiuá;657;225;113;995;
SP;350920;Cajamar;10313;3477;2051;15841;
SP;350925;Cajati;5043;1489;781;7313;
SP;350930;Cajobi;1119;358;210;1687;
SP;350940;Cajuru;3393;965;604;4962;
SP;350945;Campina do Monte Alegre;955;271;152;1378;
SP;350950;Campinas;131873;43707;24939;200519;
SP;350960;Campo Limpo Paulista;11439;3939;2248;17626;
SP;350970;Campos do Jordão;7636;2128;1400;11164;
SP;350980;Campos Novos Paulista;710;156;120;986;
SP;350990;Cananéia;2102;578;326;3006;
SP;350995;Canas;755;236;142;1133;
SP;351000;Cândido Mota;3738;1311;725;5774;
SP;351010;Cândido Rodrigues;302;83;56;441;
SP;351015;Canitar;885;187;152;1224;
SP;351020;Capão Bonito;7100;2213;1229;10542;
SP;351030;Capela do Alto;2914;741;479;4134;
SP;351040;Capivari;6933;1942;1378;10253;
SP;351050;Caraguatatuba;16073;5115;2686;23874;
SP;351060;Carapicuíba;55332;17640;7659;80631;
SP;351070;Cardoso;1411;449;274;2134;
SP;351080;Casa Branca;3417;1125;667;5209;
SP;351090;Cássia dos Coqueiros;466;123;63;652;
SP;351100;Castilho;2290;712;514;3516;
SP;351110;Catanduva;12745;4926;2429;20100;
SP;351120;Catiguá;846;270;139;1255;
SP;351130;Cedral;988;298;143;1429;
SP;351140;Cerqueira César;2720;909;491;4120;
SP;351150;Cerquilho;5223;1569;1023;7815;
SP;351160;Cesário Lange;2497;543;463;3503;
SP;351170;Charqueada;2074;583;415;3072;
SP;351190;Clementina;946;274;218;1438;
SP;351200;Colina;2360;639;322;3321;
SP;351210;Colômbia;963;336;147;1446;
SP;351220;Conchal;4009;1137;756;5902;
SP;351230;Conchas;2516;660;387;3563;
SP;351240;Cordeirópolis;3032;771;531;4334;
SP;351250;Coroados;620;195;117;932;
SP;351260;Coronel Macedo;682;216;106;1004;
SP;351270;Corumbataí;600;191;106;897;
SP;351280;Cosmópolis;8095;2288;1609;11992;
SP;351290;Cosmorama;808;253;160;1221;
SP;351300;Cotia;38279;11543;6061;55883;
SP;351310;Cravinhos;4643;1222;876;6741;
SP;351320;Cristais Paulista;1170;337;219;1726;
SP;351330;Cruzália;233;94;40;367;
SP;351340;Cruzeiro;10594;3757;1964;16315;
SP;351350;Cubatão;18429;5362;3383;27174;
SP;351360;Cunha;3034;978;221;4233;
SP;351370;Descalvado;3889;1194;665;5748;
SP;351380;Diadema;61276;20014;11003;92293;
SP;351385;Dirce Reis;181;51;36;268;
SP;351390;Divinolândia;1391;433;223;2047;
SP;351400;Dobrada;1064;317;208;1589;
SP;351410;Dois Córregos;3407;916;654;4977;
SP;351420;Dolcinópolis;268;93;46;407;
SP;351430;Dourado;1006;308;161;1475;
SP;351440;Dracena;4670;1829;865;7364;
SP;351450;Duartina;1532;521;276;2329;
SP;351460;Dumont;1119;355;208;1682;
SP;351470;Echaporã;816;248;163;1227;
SP;351480;Eldorado;2763;806;442;4011;
SP;351490;Elias Fausto;2381;734;402;3517;
SP;351492;Elisiário;362;127;82;571;
SP;351495;Embaúba;290;87;46;423;
SP;351500;Embu das Artes;39096;11279;6851;57226;
SP;351510;Embu-Guaçu;11273;3821;1893;16987;
SP;351512;Emilianópolis;342;87;66;495;
SP;351515;Engenheiro Coelho;2567;885;414;3866;
SP;351518;Espírito Santo do Pinhal;5124;1672;853;7649;
SP;351519;Espírito Santo do Turvo;721;203;131;1055;
SP;351520;Estrela d`Oeste;963;270;168;1401;
SP;351530;Estrela do Norte;345;129;76;550;
SP;351535;Euclides da Cunha Paulista;1437;553;209;2199;
SP;351540;Fartura;2223;697;439;3359;
SP;351550;Fernandópolis;7314;2876;1370;11560;
SP;351560;Fernando Prestes;659;188;122;969;
SP;351565;Fernão;205;71;37;313;
SP;351570;Ferraz de Vasconcelos;26000;9410;4028;39438;
SP;351580;Flora Rica;201;90;43;334;
SP;351590;Floreal;284;82;44;410;
SP;351600;Flórida Paulista;1400;463;259;2122;
SP;351610;Florínia;357;139;69;565;
SP;351620;Franca;44667;15667;8631;68965;
SP;351630;Francisco Morato;27703;9192;4619;41514;
SP;351640;Franco da Rocha;21794;7213;3915;32922;
SP;351650;Gabriel Monteiro;280;56;70;406;
SP;351660;Gália;708;278;142;1128;
SP;351670;Garça;5726;2057;1006;8789;
SP;351680;Gastão Vidigal;510;141;109;760;
SP;351685;Gavião Peixoto;646;228;110;984;
SP;351690;General Salgado;1152;428;238;1818;
SP;351700;Getulina;1316;383;255;1954;
SP;351710;Glicério;607;149;124;880;
SP;351720;Guaiçara;1449;404;265;2118;
SP;351730;Guaimbê;857;244;149;1250;
SP;351740;Guaíra;4917;1526;887;7330;
SP;351750;Guapiaçu;2271;524;425;3220;
SP;351760;Guapiara;2937;1043;447;4427;
SP;351770;Guará;3161;649;578;4388;
SP;351780;Guaraçaí;851;247;180;1278;
SP;351790;Guaraci;1330;397;293;2020;
SP;351800;Guarani d`Oeste;231;52;54;337;
SP;351810;Guarantã;1017;200;177;1394;
SP;351820;Guararapes;3559;1236;648;5443;
SP;351830;Guararema;4435;1318;570;6323;
SP;351840;Guaratinguetá;15149;5452;2583;23184;
SP;351850;Guareí;1590;516;273;2379;
SP;351860;Guariba;5403;1454;1099;7956;
SP;351870;Guarujá;46742;12229;8264;67235;
SP;351880;Guarulhos;195886;67506;35028;298420;
SP;351885;Guatapará;1051;328;241;1620;
SP;351890;Guzolândia;561;206;97;864;
SP;351900;Herculândia;1171;335;225;1731;
SP;351905;Holambra;2033;630;357;3020;
SP;351907;Hortolândia;28937;10047;5600;44584;
SP;351910;Iacanga;1332;390;269;1991;
SP;351920;Iacri;720;209;128;1057;
SP;351925;Iaras;1050;349;161;1560;
SP;351930;Ibaté;4802;1361;861;7024;
SP;351940;Ibirá;1150;366;271;1787;
SP;351950;Ibirarema;925;232;168;1325;
SP;351960;Ibitinga;6529;1865;1206;9600;
SP;351970;Ibiúna;11695;3396;1645;16736;
SP;351980;Icém;1117;316;203;1636;
SP;351990;Iepê;940;361;171;1472;
SP;352000;Igaraçu do Tietê;2996;793;539;4328;
SP;352010;Igarapava;3580;1063;740;5383;
SP;352020;Igaratá;1540;471;264;2275;
SP;352030;Iguape;4494;1347;728;6569;
SP;352040;Ilhabela;4427;1361;875;6663;
SP;352042;Ilha Comprida;1292;304;201;1797;
SP;352044;Ilha Solteira;2880;1115;466;4461;
SP;352050;Indaiatuba;27564;8837;5322;41723;
SP;352060;Indiana;502;195;84;781;
SP;352070;Indiaporã;412;144;81;637;
SP;352080;Inúbia Paulista;445;150;89;684;
SP;352090;Ipaussu;2090;837;395;3322;
SP;352100;Iperó;4052;1091;788;5931;
SP;352110;Ipeúna;997;281;177;1455;
SP;352115;Ipiguá;631;176;86;893;
SP;352120;Iporanga;728;250;122;1100;
SP;352130;Ipuã;2126;573;409;3108;
SP;352140;Iracemápolis;2641;702;550;3893;
SP;352150;Irapuã;882;296;198;1376;
SP;352160;Irapuru;750;277;105;1132;
SP;352170;Itaberá;2492;781;440;3713;
SP;352180;Itaí;3305;968;622;4895;
SP;352190;Itajobi;1580;473;286;2339;
SP;352200;Itaju;468;134;74;676;
SP;352210;Itanhaém;14919;4507;2501;21927;
SP;352215;Itaóca;538;239;100;877;
SP;352220;Itapecerica da Serra;26912;8289;4009;39210;
SP;352230;Itapetininga;22073;6395;3619;32087;
SP;352240;Itapeva;14119;4812;2452;21383;
SP;352250;Itapevi;35862;11078;6031;52971;
SP;352260;Itapira;8179;2832;1352;12363;
SP;352265;Itapirapuã Paulista;771;244;120;1135;
SP;352270;Itápolis;4574;1487;832;6893;
SP;352280;Itaporanga;2181;623;417;3221;
SP;352290;Itapuí;1593;429;329;2351;
SP;352300;Itapura;644;161;107;912;
SP;352310;Itaquaquecetuba;55472;17578;8423;81473;
SP;352320;Itararé;6939;2323;1019;10281;
SP;352330;Itariri;2221;625;316;3162;
SP;352340;Itatiba;13971;4333;2527;20831;
SP;352350;Itatinga;2973;621;558;4152;
SP;352360;Itirapina;1796;519;361;2676;
SP;352370;Itirapuã;894;240;167;1301;
SP;352380;Itobi;971;225;195;1391;
SP;352390;Itu;23034;6650;4215;33899;
SP;352400;Itupeva;7351;2054;1495;10900;
SP;352410;Ituverava;5078;1614;857;7549;
SP;352420;Jaborandi;792;182;161;1135;
SP;352430;Jaboticabal;9195;3007;1574;13776;
SP;352440;Jacareí;29363;10239;5024;44626;
SP;352450;Jaci;751;253;150;1154;
SP;352460;Jacupiranga;2420;835;345;3600;
SP;352470;Jaguariúna;6327;1947;1196;9470;
SP;352480;Jales;5164;2131;941;8236;
SP;352490;Jambeiro;931;218;137;1286;
SP;352500;Jandira;15339;5338;2919;23596;
SP;352510;Jardinópolis;5597;1450;1063;8110;
SP;352520;Jarinu;4117;1301;742;6160;
SP;352530;Jaú;16267;5367;3258;24892;
SP;352540;Jeriquara;533;143;103;779;
SP;352550;Joanópolis;1520;376;273;2169;
SP;352560;João Ramalho;561;142;93;796;
SP;352570;José Bonifácio;4322;1367;771;6460;
SP;352580;Júlio Mesquita;674;223;101;998;
SP;352585;Jumirim;412;101;58;571;
SP;352590;Jundiaí;48238;17118;9148;74504;
SP;352600;Junqueirópolis;1990;796;374;3160;
SP;352610;Juquiá;3376;1039;459;4874;
SP;352620;Juquitiba;5200;1700;857;7757;
SP;352630;Lagoinha;716;239;114;1069;
SP;352640;Laranjal Paulista;3664;894;586;5144;
SP;352650;Lavínia;607;190;98;895;
SP;352660;Lavrinhas;962;307;164;1433;
SP;352670;Leme;12478;4021;2482;18981;
SP;352680;Lençóis Paulista;8478;2722;1578;12778;
SP;352690;Limeira;35869;12385;6014;54268;
SP;352700;Lindóia;910;153;154;1217;
SP;352710;Lins;9018;3276;1500;13794;
SP;352720;Lorena;11708;3393;2018;17119;
SP;352725;Lourdes;258;82;55;395;
SP;352730;Louveira;5221;1331;1075;7627;
SP;352740;Lucélia;2294;619;360;3273;
SP;352750;Lucianópolis;307;104;47;458;
SP;352760;Luís Antônio;1892;446;345;2683;
SP;352770;Luiziânia;560;198;145;903;
SP;352780;Lupércio;600;186;130;916;
SP;352790;Lutécia;395;135;69;599;
SP;352800;Macatuba;2156;721;472;3349;
SP;352810;Macaubal;743;261;154;1158;
SP;352820;Macedônia;392;139;71;602;
SP;352830;Magda;335;113;64;512;
SP;352840;Mairinque;7590;1996;1346;10932;
SP;352850;Mairiporã;12231;3732;2137;18100;
SP;352860;Manduri;1108;284;235;1627;
SP;352870;Marabá Paulista;480;156;66;702;
SP;352880;Maracaí;1764;568;329;2661;
SP;352885;Marapoama;297;100;55;452;
SP;352890;Mariápolis;400;142;74;616;
SP;352900;Marília;27615;9791;5181;42587;
SP;352910;Marinópolis;264;97;39;400;
SP;352920;Martinópolis;2866;1023;573;4462;
SP;352930;Matão;9835;3365;1794;14994;
SP;352940;Mauá;57298;18935;9415;85648;
SP;352950;Mendonça;535;187;113;835;
SP;352960;Meridiano;442;177;90;709;
SP;352965;Mesópolis;195;79;50;324;
SP;352970;Miguelópolis;2816;826;478;4120;
SP;352980;Mineiros do Tietê;1581;566;295;2442;
SP;352990;Miracatu;3762;948;563;5273;
SP;353000;Mira Estrela;328;118;51;497;
SP;353010;Mirandópolis;2781;1006;517;4304;
SP;353020;Mirante do Paranapanema;2345;803;319;3467;
SP;353030;Mirassol;6583;2316;1305;10204;
SP;353040;Mirassolândia;515;145;106;766;
SP;353050;Mococa;8686;3004;1493;13183;
SP;353060;Mogi das Cruzes;58869;20107;10781;89757;
SP;353070;Mogi Guaçu;18033;6231;3400;27664;
SP;353080;Moji Mirim;11224;3590;1774;16588;
SP;353090;Mombuca;556;139;99;794;
SP;353100;Monções;201;92;35;328;
SP;353110;Mongaguá;7975;2487;1635;12097;
SP;353120;Monte Alegre do Sul;865;295;131;1291;
SP;353130;Monte Alto;5353;1735;926;8014;
SP;353140;Monte Aprazível;2356;833;453;3642;
SP;353150;Monte Azul Paulista;2225;641;439;3305;
SP;353160;Monte Castelo;452;175;77;704;
SP;353170;Monteiro Lobato;716;208;92;1016;
SP;353180;Monte Mor;8671;2393;1684;12748;
SP;353190;Morro Agudo;4204;990;767;5961;
SP;353200;Morungaba;1838;507;327;2672;
SP;353205;Motuca;618;204;101;923;
SP;353210;Murutinga do Sul;451;144;57;652;
SP;353215;Nantes;421;152;71;644;
SP;353220;Narandiba;686;213;127;1026;
SP;353230;Natividade da Serra;909;326;79;1314;
SP;353240;Nazaré Paulista;2279;716;386;3381;
SP;353250;Neves Paulista;844;269;157;1270;
SP;353260;Nhandeara;1098;390;187;1675;
SP;353270;Nipoã;573;138;127;838;
SP;353280;Nova Aliança;743;219;130;1092;
SP;353282;Nova Campina;1711;422;277;2410;
SP;353284;Nova Canaã Paulista;199;81;43;323;
SP;353286;Nova Castilho;133;63;33;229;
SP;353290;Nova Europa;1217;401;72;1690;
SP;353300;Nova Granada;2416;943;477;3836;
SP;353310;Nova Guataporanga;264;83;43;390;
SP;353320;Nova Independência;492;167;120;779;
SP;353325;Novais;657;178;149;984;
SP;353330;Nova Luzitânia;432;134;97;663;
SP;353340;Nova Odessa;7113;2486;1297;10896;
SP;353350;Novo Horizonte;4582;1412;827;6821;
SP;353360;Nuporanga;861;252;165;1278;
SP;353370;Ocauçu;523;142;97;762;
SP;353380;Óleo;380;113;57;550;
SP;353390;Olímpia;5910;2071;1173;9154;
SP;353400;Onda Verde;524;159;114;797;
SP;353410;Oriente;623;219;119;961;
SP;353420;Orindiúva;839;263;179;1281;
SP;353430;Orlândia;5460;1840;1018;8318;
SP;353440;Osasco;101618;34415;17411;153444;
SP;353450;Oscar Bressane;273;99;61;433;
SP;353460;Osvaldo Cruz;3275;1284;578;5137;
SP;353470;Ourinhos;13603;4516;2503;20622;
SP;353475;Ouroeste;1122;376;212;1710;
SP;353480;Ouro Verde;1084;346;184;1614;
SP;353490;Pacaembu;1256;394;255;1905;
SP;353500;Palestina;1162;411;255;1828;
SP;353510;Palmares Paulista;1463;468;316;2247;
SP;353520;Palmeira d`Oeste;1014;376;162;1552;
SP;353530;Palmital;2547;899;526;3972;
SP;353540;Panorama;2160;656;373;3189;
SP;353550;Paraguaçu Paulista;5437;2032;1093;8562;
SP;353560;Paraibuna;2525;690;441;3656;
SP;353570;Paraíso;782;234;145;1161;
SP;353580;Paranapanema;2747;755;467;3969;
SP;353590;Paranapuã;512;173;69;754;
SP;353600;Parapuã;1171;406;200;1777;
SP;353610;Pardinho;917;308;147;1372;
SP;353620;Pariquera-Açu;3051;1063;478;4592;
SP;353625;Parisi;262;88;51;401;
SP;353630;Patrocínio Paulista;1875;509;341;2725;
SP;353640;Paulicéia;1042;283;192;1517;
SP;353650;Paulínia;12919;3610;2546;19075;
SP;353657;Paulistânia;256;69;34;359;
SP;353660;Paulo de Faria;1051;341;187;1579;
SP;353670;Pederneiras;5959;1958;1183;9100;
SP;353680;Pedra Bela;753;250;135;1138;
SP;353690;Pedranópolis;297;77;49;423;
SP;353700;Pedregulho;2172;596;386;3154;
SP;353710;Pedreira;5254;1599;887;7740;
SP;353715;Pedrinhas Paulista;338;116;61;515;
SP;353720;Pedro de Toledo;1651;441;250;2342;
SP;353730;Penápolis;7110;2541;1349;11000;
SP;353740;Pereira Barreto;2814;1045;631;4490;
SP;353750;Pereiras;987;262;202;1451;
SP;353760;Peruíbe;10788;3340;1777;15905;
SP;353770;Piacatu;675;240;155;1070;
SP;353780;Piedade;7462;2419;1245;11126;
SP;353790;Pilar do Sul;4095;1260;687;6042;
SP;353800;Pindamonhangaba;21440;6950;3134;31524;
SP;353810;Pindorama;1664;396;317;2377;
SP;353820;Pinhalzinho;1854;474;307;2635;
SP;353830;Piquerobi;410;123;71;604;
SP;353850;Piquete;1689;479;276;2444;
SP;353860;Piracaia;3898;1088;612;5598;
SP;353870;Piracicaba;47846;16264;8390;72500;
SP;353880;Piraju;3769;1302;644;5715;
SP;353890;Pirajuí;2377;855;474;3706;
SP;353900;Pirangi;1257;477;229;1963;
SP;353910;Pirapora do Bom Jesus;3201;735;614;4550;
SP;353920;Pirapozinho;3256;1131;506;4893;
SP;353930;Pirassununga;8792;2998;1541;13331;
SP;353940;Piratininga;1640;442;221;2303;
SP;353950;Pitangueiras;5445;1583;1011;8039;
SP;353960;Planalto;693;156;152;1001;
SP;353970;Platina;460;134;103;697;
SP;353980;Poá;18971;7289;3274;29534;
SP;353990;Poloni;601;187;121;909;
SP;354000;Pompéia;2527;770;461;3758;
SP;354010;Pongaí;389;128;60;577;
SP;354020;Pontal;5984;1531;1223;8738;
SP;354025;Pontalinda;516;148;101;765;
SP;354030;Pontes Gestal;302;79;63;444;
SP;354040;Populina;488;156;82;726;
SP;354050;Porangaba;1029;317;132;1478;
SP;354060;Porto Feliz;6882;2169;1225;10276;
SP;354070;Porto Ferreira;6706;1945;1396;10047;
SP;354075;Potim;2265;475;471;3211;
SP;354080;Potirendaba;1899;493;331;2723;
SP;354085;Pracinha;216;72;35;323;
SP;354090;Pradópolis;2294;621;488;3403;
SP;354100;Praia Grande;42386;11306;7323;61015;
SP;354105;Pratânia;892;298;165;1355;
SP;354110;Presidente Alves;459;166;86;711;
SP;354120;Presidente Bernardes;1409;477;250;2136;
SP;354130;Presidente Epitácio;5482;1903;963;8348;
SP;354140;Presidente Prudente;25338;8974;4295;38607;
SP;354150;Presidente Venceslau;4296;1460;759;6515;
SP;354160;Promissão;4784;1597;1041;7422;
SP;354165;Quadra;537;145;110;792;
SP;354170;Quatá;1664;631;332;2627;
SP;354180;Queiroz;456;149;80;685;
SP;354190;Queluz;1477;354;255;2086;
SP;354200;Quintana;710;254;146;1110;
SP;354210;Rafard;1307;358;214;1879;
SP;354220;Rancharia;3857;1481;582;5920;
SP;354230;Redenção da Serra;633;190;85;908;
SP;354240;Regente Feijó;2375;748;497;3620;
SP;354250;Reginópolis;667;180;141;988;
SP;354260;Registro;9172;2910;1412;13494;
SP;354270;Restinga;1249;292;204;1745;
SP;354280;Ribeira;603;221;81;905;
SP;354290;Ribeirão Bonito;1812;507;327;2646;
SP;354300;Ribeirão Branco;3347;961;529;4837;
SP;354310;Ribeirão Corrente;735;243;116;1094;
SP;354320;Ribeirão do Sul;628;206;106;940;
SP;354323;Ribeirão dos Índios;252;88;50;390;
SP;354325;Ribeirão Grande;1171;384;221;1776;
SP;354330;Ribeirão Pires;15627;5396;2805;23828;
SP;354340;Ribeirão Preto;73242;25843;13387;112472;
SP;354350;Riversul;836;302;150;1288;
SP;354360;Rifaina;492;145;72;709;
SP;354370;Rincão;1444;502;286;2232;
SP;354380;Rinópolis;1070;293;243;1606;
SP;354390;Rio Claro;23117;7491;4550;35158;
SP;354400;Rio das Pedras;4232;1105;817;6154;
SP;354410;Rio Grande da Serra;5558;1912;1055;8525;
SP;354420;Riolândia;1298;478;284;2060;
SP;354425;Rosana;2869;1128;408;4405;
SP;354430;Roseira;1340;366;262;1968;
SP;354440;Rubiácea;346;124;60;530;
SP;354450;Rubinéia;335;119;58;512;
SP;354460;Sabino;627;185;137;949;
SP;354470;Sagres;326;101;58;485;
SP;354480;Sales;706;227;116;1049;
SP;354490;Sales Oliveira;1282;311;257;1850;
SP;354500;Salesópolis;2711;826;337;3874;
SP;354510;Salmourão;675;196;117;988;
SP;354515;Saltinho;954;269;168;1391;
SP;354520;Salto;14544;4960;2646;22150;
SP;354530;Salto de Pirapora;5906;1748;1013;8667;
SP;354540;Salto Grande;1223;286;218;1727;
SP;354550;Sandovalina;548;225;123;896;
SP;354560;Santa Adélia;1783;574;340;2697;
SP;354570;Santa Albertina;619;189;91;899;
SP;354580;Santa Bárbara d`Oeste;21141;6418;4115;31674;
SP;354600;Santa Branca;1928;451;360;2739;
SP;354610;Santa Clara d`Oeste;229;88;44;361;
SP;354620;Santa Cruz da Conceição;538;146;101;785;
SP;354625;Santa Cruz da Esperança;284;111;51;446;
SP;354630;Santa Cruz das Palmeiras;4082;1229;949;6260;
SP;354640;Santa Cruz do Rio Pardo;5909;1888;881;8678;
SP;354650;Santa Ernestina;781;247;152;1180;
SP;354660;Santa Fé do Sul;3411;1231;589;5231;
SP;354670;Santa Gertrudes;3330;858;692;4880;
SP;354680;Santa Isabel;7752;2484;1388;11624;
SP;354690;Santa Lúcia;1134;396;255;1785;
SP;354700;Santa Maria da Serra;843;202;166;1211;
SP;354710;Santa Mercedes;429;160;86;675;
SP;354720;Santana da Ponte Pensa;122;59;26;207;
SP;354730;Santana de Parnaíba;21840;5875;3044;30759;
SP;354740;Santa Rita d`Oeste;231;102;34;367;
SP;354750;Santa Rita do Passa Quatro;2916;875;521;4312;
SP;354760;Santa Rosa de Viterbo;2924;1155;563;4642;
SP;354765;Santa Salete;192;51;32;275;
SP;354770;Santo Anastácio;2478;922;379;3779;
SP;354780;Santo André;86872;31739;15491;134102;
SP;354790;Santo Antônio da Alegria;855;271;176;1302;
SP;354800;Santo Antônio de Posse;3175;725;559;4459;
SP;354805;Santo Antônio do Aracanguá;966;356;173;1495;
SP;354810;Santo Antônio do Jardim;903;268;138;1309;
SP;354820;Santo Antônio do Pinhal;1244;352;188;1784;
SP;354830;Santo Expedito;374;133;65;572;
SP;354840;Santópolis do Aguapeí;574;212;109;895;
SP;354850;Santos;46694;14927;8747;70368;
SP;354860;São Bento do Sapucaí;1350;497;194;2041;
SP;354870;São Bernardo do Campo;104485;37267;19760;161512;
SP;354880;São Caetano do Sul;19899;8411;3077;31387;
SP;354890;São Carlos;27652;9430;5394;42476;
SP;354900;São Francisco;342;88;52;482;
SP;354910;São João da Boa Vista;9911;3610;1870;15391;
SP;354920;São João das Duas Pontes;326;122;51;499;
SP;354925;São João de Iracema;207;83;40;330;
SP;354930;São João do Pau d`Alho;212;101;43;356;
SP;354940;São Joaquim da Barra;5852;2100;1131;9083;
SP;354950;São José da Bela Vista;1314;367;237;1918;
SP;354960;São José do Barreiro;670;216;113;999;
SP;354970;São José do Rio Pardo;6139;2173;1175;9487;
SP;354980;São José do Rio Preto;46344;16260;9321;71925;
SP;354990;São José dos Campos;85839;30752;16127;132718;
SP;354995;São Lourenço da Serra;2061;739;337;3137;
SP;355000;São Luís do Paraitinga;1590;471;218;2279;
SP;355010;São Manuel;5257;1747;858;7862;
SP;355020;São Miguel Arcanjo;4887;1328;832;7047;
SP;355030;São Paulo;1531007;504615;259095;2294717;
SP;355040;São Pedro;4432;1059;725;6216;
SP;355050;São Pedro do Turvo;1001;328;191;1520;
SP;355060;São Roque;11811;3321;1682;16814;
SP;355070;São Sebastião;12076;3666;2432;18174;
SP;355080;São Sebastião da Grama;1624;451;260;2335;
SP;355090;São Simão;2135;683;371;3189;
SP;355100;São Vicente;47536;14577;8334;70447;
SP;355110;Sarapuí;1516;462;207;2185;
SP;355120;Sarutaiá;513;162;101;776;
SP;355130;Sebastianópolis do Sul;287;122;87;496;
SP;355140;Serra Azul;1478;407;289;2174;
SP;355150;Serrana;6106;1802;1241;9149;
SP;355160;Serra Negra;3146;901;575;4622;
SP;355170;Sertãozinho;15599;4786;2972;23357;
SP;355180;Sete Barras;2318;619;391;3328;
SP;355190;Severínia;2287;610;463;3360;
SP;355200;Silveiras;965;212;168;1345;
SP;355210;Socorro;4297;1293;715;6305;
SP;355220;Sorocaba;83621;28442;15172;127235;
SP;355230;Sud Mennucci;958;336;175;1469;
SP;355240;Sumaré;34055;10897;6558;51510;
SP;355250;Suzano;45353;16168;7716;69237;
SP;355255;Suzanápolis;446;149;84;679;
SP;355260;Tabapuã;1259;369;290;1918;
SP;355270;Tabatinga;1991;598;369;2958;
SP;355280;Taboão da Serra;40165;11639;6523;58327;
SP;355290;Taciba;789;253;142;1184;
SP;355300;Taguaí;1467;437;325;2229;
SP;355310;Taiaçu;772;251;141;1164;
SP;355320;Taiúva;565;154;103;822;
SP;355330;Tambaú;2837;930;539;4306;
SP;355340;Tanabi;2624;910;503;4037;
SP;355350;Tapiraí;1339;412;208;1959;
SP;355360;Tapiratiba;1594;516;260;2370;
SP;355365;Taquaral;330;104;66;500;
SP;355370;Taquaritinga;6807;2489;1293;10589;
SP;355380;Taquarituba;3069;1078;584;4731;
SP;355385;Taquarivaí;970;457;164;1591;
SP;355390;Tarabai;998;328;179;1505;
SP;355395;Tarumã;1968;521;391;2880;
SP;355400;Tatuí;16435;4993;2886;24314;
SP;355410;Taubaté;40817;11982;7450;60249;
SP;355420;Tejupá;863;241;144;1248;
SP;355430;Teodoro Sampaio;3221;1002;519;4742;
SP;355440;Terra Roxa;967;362;243;1572;
SP;355450;Tietê;4887;1610;837;7334;
SP;355460;Timburi;338;119;53;510;
SP;355465;Torre de Pedra;332;118;68;518;
SP;355470;Torrinha;1046;319;193;1558;
SP;355475;Trabiju;250;109;43;402;
SP;355480;Tremembé;5104;1201;727;7032;
SP;355490;Três Fronteiras;566;205;102;873;
SP;355495;Tuiuti;810;209;97;1116;
SP;355500;Tupã;7291;2814;1302;11407;
SP;355510;Tupi Paulista;1364;542;230;2136;
SP;355520;Turiúba;198;64;41;303;
SP;355530;Turmalina;195;51;28;274;
SP;355535;Ubarana;821;264;148;1233;
SP;355540;Ubatuba;12140;4053;2250;18443;
SP;355550;Ubirajara;580;207;109;896;
SP;355560;Uchoa;1142;294;217;1653;
SP;355570;União Paulista;233;61;58;352;
SP;355580;Urânia;858;305;165;1328;
SP;355590;Uru;179;59;22;260;
SP;355600;Urupês;1447;614;249;2310;
SP;355610;Valentim Gentil;1371;435;269;2075;
SP;355620;Valinhos;15529;5091;2694;23314;
SP;355630;Valparaíso;2637;915;545;4097;
SP;355635;Vargem;1362;374;237;1973;
SP;355640;Vargem Grande do Sul;4986;1514;1024;7524;
SP;355645;Vargem Grande Paulista;7147;2203;1436;10786;
SP;355650;Várzea Paulista;12892;4068;2372;19332;
SP;355660;Vera Cruz;1259;540;238;2037;
SP;355670;Vinhedo;9403;2781;1749;13933;
SP;355680;Viradouro;2374;615;469;3458;
SP;355690;Vista Alegre do Alto;816;246;162;1224;
SP;355695;Vitória Brasil;186;43;48;277;
SP;355700;Votorantim;15080;4202;2722;22004;
SP;355710;Votuporanga;9155;3591;1769;14515;
SP;355715;Zacarias;294;83;61;438;
SP;355720;Chavantes;1685;387;303;2375;
SP;355730;Estiva Gerbi;1490;441;217;2148;
